tanks
20x10
3XXRXXXXXXTXXXXXXXX2
XXXXXXXRXXXXXXTXXXXX
RXXBXXXXXXXXBXXXXXXX
WWXXXTXXXXXXXXXXRXXT
WWXXXXXXXXXXXXXXXXXX
XXXTXXXXXXXXXXXXXXWW
TXXXXXBXXTXXRXXXXXWW
XXRXXXXXXXXXXXXXXXXR
XXXXXXXXXXXXXXBXXXXX
1XXXXRXXXXXXXXXXXXX4
